1111111111111
10C00000000C1
1CPC011111001
10C001E000001
1111111111111
