1111111111111
10N1000000001
1000011110C01
1P0011ENC0001
111000CC10001
1111111111111
