111111111111111111111111111
110001110110010011NNNNNNNN1
101111110101101101000000001
10110011011011101100C000001
1001101101110101110000C0001
1100011101111011110C0000001
1111111111111111110000E0001
110001011011000101000000001
101111011010111101C0000C001
1011110110101111010C0000001
1011110110101111010000C0001
110001100111000101000P00001
111111111111111111111111111
