1111111111111111111111111111
1000000000000000000000000001
1001110001001101100NNNNNNNN1
1010000001010010010000000001
101001100100100010000C000001
10110010010001010000000C0001
10011100010000100000C0000001
10000000000000000000000E0001
1001110100100111010000000001
1010000100101000010C0000C001
10100001001010000100C0000001
10100001001010000100000C0001
1001110011000111010000P00001
1000000000000000000000000001
1111111111111111111111111111
