111111111111111111111111111
101110001001101100NNNNNNNN1
110000001010010010000000001
11001100100100010000C000001
1110010010001010000000C0001
1011100010000100000C0000001
1000000000000000000000E0001
101110100100111010000000001
110000100101000010C0000C001
1100001001010000100C0000001
1100001001010000100000C0001
101110011000111010000P00001
111111111111111111111111111
