111111111111111111111111111
110001110110111011000000001
101110110101100101000000001
111110110110111011000000001
100010110111010111000000001
110001110111101111000000001
111111111111111111000000001
110001011011000101000000001
101111011010111101000000001
101111011010111101000000001
101111011010111101000000001
110001100111000101000000001
111111111111111111111111111